####################
#P   T    #   T    #
# ###  ## # ###### #
#   #   # #      # #
### ### # ###### # #
#     # #        # #
# # # # ######## # #
# # # #    A     # #
# # # ########## # #
# # #            # #
# # ############## #
# #   A            #
# ################ #
#                  #
#################S##
