##############################
#P   T     #    T   #   T    #
# ######   # ###### # ####   #
# #    #   #      # # # A    #
# # ## # # ###### # # ####   #
# #  # # #        # #        #
# ## # # ########## # ####   #
#    #   #     A      #   T  #
#### # ################      #
##########################S###
