##########
#P    #  #
# ## ## A#
#T #     #
# ## # # #
#    # # #
# ## #   #
#  # # # #
#  #     #
#######S##
